{
    "ver": "2.3",
    "ref": "230616-7537f424-f7c4-401c-bea9-ed4a29a5229b",
    "log": [ [ [ 0, 0, 0 ],
        [ 25000, 25000, 25000, 25000 ],
        [ 45 ],
        [ 44 ],
        [ 34, 47, 39, 23, 35, 42, 25, 16, 32, 22, 35, 53, 11 ],
        [ 17, 12, 42, 37, 29, 42, 33, 31, 16, 43, 42, 28, 21, 11 ],
        [ 42, 39, 60, 11, 60, 47, 12, 37, 25, 60, 16, 60, "r31", 60 ],
        [ 34, 12, 47, 28, 41, 24, 33, 16, 17, 13, 11, 44, 47 ],
        [ 12, 39, 36, 44, 32, "p474747", 15, 38, 26, 44, 13, 43, 37, 18 ],
        [ 28, 60, 44, 60, 41, 24, 36, 60, 12, 60, 60, 60, 60, 60 ],
        [ 38, 46, 13, 39, 31, 45, 27, 46, 41, 23, 24, 26, 32 ],
        [ "c282627", 13, 19, 41, "p414141", 14, 51, 14, 46, 32, 21, 18, 29 ],
        [ 13, 60, 60, 45, 31, 60, 60, 60, 32, 60, 39, 60, 38 ],
        [ 41, 28, 34, 38, 29, 22, 24, 43, 38, 14, 36, 17, 24 ],
        [ 16, 19, 45, 36, 15, 28, 39, 11, 43, 19, 37, 26, 12 ],
        [ 43, 41, 60, 19, 29, 34, 60, 60, 60, 60, 60, 14, 38 ],
        [ "和了", [ 4900, -3900, 0, 0 ],
        [ 0, 1, 0, "40符2飜3900点", "Riichi(1飜)", "Red Five(1飜)", "Ura Dora(0飜)" ] ] ],
        [ [ 0, 1, 0 ],
        [ 28900, 21100, 25000, 25000 ],
        [ 33, 13 ],
        [],
        [ 33, 26, 52, 28, 32, 44, 32, 34, 12, 17, 25, 45, 15 ],
        [ 44, 35, 31, 25, 33, 23, "c323334", 21, 18, 11, 43, 14 ],
        [ 12, 45, 44, 31, 44, 60, 28, 60, 60, 60, 60, 17 ],
        [ 36, 43, 46, 33, 29, 37, 21, 21, 13, 13, 39, 18, 43 ],
        [ 14, 27, 19, 11, 32, 12, 26, 19, 42, 27 ],
        [ 29, 39, 46, 60, 27, 13, 60, 43, 60, 43 ],
        [ 17, 29, 41, 45, 39, 46, 38, 35, 12, 28, 37, 23, 45 ],
        [ 47, "45p4545", 34, 37, 23, "c272829", 41, 44, 26, 45, 22, 36 ],
        [ 41, 47, 46, 23, 60, 37, 60, 60, 60, "45k454545", 60, 12 ],
        [ 11, 18, 28, 34, 42, 32, 12, 43, 16, 11, 22, 22, 36 ],
        [ 51, 14, 15, 46, 39, 35, 47, 15, 16, "p222222", 36 ],
        [ 42, 43, 28, 60, 60, 32, 60, 11, 11, 12, 60 ],
        [ "和了", [ -2900, 0, 2900, 0 ],
        [ 2, 0, 2, "40符2飜2600点", "White Dragon(1飜)", "Dora(1飜)" ],
        [ -8000, 0, 0, 8000 ],
        [ 3, 0, 3, "30符4飜7700点", "All Simples(1飜)", "Dora(2飜)", "Red Five(1飜)" ] ] ],
        [ [ 1, 0, 0 ],
        [ 18300, 21100, 27900, 32700 ],
        [ 45 ],
        [ 23 ],
        [ 51, 12, 42, 36, 17, 43, 37, 41, 23, 27, 19, 13, 26 ],
        [ 21, 41, 23, 47, 34, 43, 33, 53, 39, 11, 19, 34, 18, 31 ],
        [ 41, 42, 41, 60, 43, 60, 21, 19, 60, 36, 60, 60, 37, 60 ],
        [ 14, 42, 35, 21, 29, 47, 14, 25, 29, 27, 39, 33, 38 ],
        [ 31, 46, 11, 19, 32, 36, 13, 24, 46, 12, 28, 43, 34, 28, 36, "4646p46" ],
        [ 42, 21, 60, 60, 47, 39, 38, 27, 13, 60, 60, 60, 29, 60, 29, 36 ],
        [ 22, 35, 22, 18, 11, 42, 41, 22, 32, 52, 27, 38, 37 ],
        [ 31, 45, 25, 14, 33, 23, 17, 39, 32, 21, 26, 43, 44, 34, 46 ],
        [ 11, 60, 42, 41, 18, 38, 60, 60, 32, 25, 14, 60, 60, "r37", 60 ],
        [ 44, 39, 12, 27, 18, 15, 28, 45, 24, 29, 44, 47, 35 ],
        [ 16, 37, 44, 15, 13, 24, 16, 24, 19, 13, 31, 18, 16, 46 ],
        [ 47, 45, 12, 24, 60, 60, 39, 60, 18, 60, 19, 60, 31, 44 ],
        [ "和了", [ 0, -3900, 4900, 0 ],
        [ 2, 1, 2, "30符3飜3900点", "Pinfu(1飜)", "Riichi(1飜)", "Red Five(1飜)", "Ura Dora(0飜)" ] ] ],
        [ [ 2, 0, 0 ],
        [ 18300, 17200, 31800, 32700 ],
        [ 31 ],
        [],
        [ 53, 34, 17, 17, 41, 29, 11, 13, 36, 16, 39, 37, 27 ],
        [ 41, 21, 27, 22, 26, 15, 26, 45, 43, 35, 12, 43 ],
        [ 11, 60, 13, 60, 17, 29, 39, 34, 60, 60, 60, 60 ],
        [ 45, 21, 18, 39, 31, 35, 42, 25, 39, 23, 32, 24, 36 ],
        [ 46, 33, 32, 44, 38, 24, 46, 15, 35, 44, 16, 18 ],
        [ 42, 46, 45, 60, 18, 21, 60, 60, 24, 60, 60, 60 ],
        [ 29, 26, 19, 22, 15, 13, 26, 38, 39, 13, 14, 43, 34 ],
        [ 28, 44, 21, 52, 37, 28, 18, 16, 34, 47, 45, 31, 21 ],
        [ 43, 60, 19, 26, 34, 29, 13, 18, 60, 60, 60, 60, 60 ],
        [ 12, 25, 11, 25, 23, 19, 22, 47, 37, 24, 34, 17, 31 ],
        [ 36, 18, 14, 38, 42, 27, 46, 23, 43, 27, 22, 28, 13 ],
        [ 47, 31, 11, 34, 60, 60, 60, 23, 60, 60, 60, 60 ],
        [ "和了", [ -300, -300, -500, 1100 ],
        [ 3, 3, 3, "30符1飜300-500点", "Fully Concealed Hand(1飜)" ] ] ],
        [ [ 3, 0, 0 ],
        [ 18000, 16900, 31300, 33800 ],
        [ 35 ],
        [],
        [ 37, 31, 36, 46, 28, 39, 12, 15, 17, 32, 28, 28, 46 ],
        [ 13, 35, 16, 44, "46p4646", 11, 21, 31, 34, 47, 38, 33 ],
        [ 39, 17, 60, 60, 15, 28, 60, 60, 60, 60, 60 ],
        [ 39, 41, 32, 18, 46, 19, 22, 39, 29, 19, 17, 34, 21 ],
        [ 36, 23, 45, 42, 27, 31, 35, 34, 25, 32, 41 ],
        [ 32, 19, 60, 60, 46, 60, 41, 60, 60, 60, "r60" ],
        [ 33, 18, 36, 26, 29, 11, 18, 21, 46, 22, 18, 23, 41 ],
        [ 44, 27, 33, 27, 17, 19, 19, 27, 45, 33, 43 ],
        [ 41, 11, 29, 46, 44, 27, 36, 60, 60, "r19", 60 ],
        [ 47, 43, 37, 13, 24, 44, 22, 26, 14, 17, 42, 45, 29 ],
        [ 25, 52, 47, 24, 37, 15, 13, 21, 37, 47, 44 ],
        [ 45, 47, 44, 42, 43, 29, 22, 60, 17, 47, 47 ],
        [ "和了", [ 4000, -500, -500, -1000 ],
        [ 0, 0, 0, "30符2飜500-1000点", "Green Dragon(1飜)", "Dora(1飜)" ] ] ] ],
    "ratingc": "PF4",
    "rule": { "disp": "Gold Room East", "aka53": 1, "aka52": 1, "aka51": 1 },
    "lobby": 0,
    "dan": [ "Expert I", "Expert III", "Expert II", "Expert III" ],
    "rate": [ 756, 500, 541, 1976 ],
    "sx": [ "F", "F", "F", "F" ],
    "name": [ "放銃時行", "喰いタンの竜", "プリン吉田", "宇智波带秃" ],
    "sc": [ 22000, -8, 15400, -24.6, 29800, 9.8, 32800, 22.8 ],
    "title": [ "Gold Room East", "2023/6/16 20:06:17" ]
}